8,8,8,8,8,8,8,8,8,8,8,8,8,8,8,8,8,8,8,8,8,8,8,8,8,8,8,8,8,8,8,8,8,8,8,8,8,8,8,8,8,8,8,8,8,8,8,8,8,8,8,8,8,8,8,8,8,8,8,8
8,8,8,8,8,8,8,8,8,8,8,8,8,8,8,8,8,8,8,8,8,8,8,8,8,8,8,8,8,8,8,8,8,8,8,8,8,8,8,8,8,8,8,8,8,8,8,8,8,8,8,8,8,8,8,8,8,8,8,8
8,8,8,8,8,8,8,8,8,8,8,8,8,8,8,8,8,8,8,8,8,8,8,8,8,8,8,8,8,8,8,8,8,8,8,8,8,8,8,8,8,8,8,8,8,8,8,8,8,8,8,8,8,8,8,8,8,8,8,8
8,8,8,8,8,8,8,8,8,8,8,8,8,8,8,8,8,8,8,8,8,8,8,8,8,8,8,8,8,8,8,8,8,8,8,8,8,8,8,8,8,8,8,8,8,8,8,8,8,8,8,8,8,8,8,8,8,8,8,8
8,8,8,8,8,8,8,8,8,8,8,8,8,8,8,8,8,8,8,8,8,8,8,8,8,8,8,8,8,8,8,8,8,8,8,8,8,8,8,8,8,8,8,8,8,8,8,8,8,8,8,8,8,8,8,8,8,8,8,8
8,8,8,8,8,8,8,8,8,8,8,8,8,8,8,8,8,8,8,8,8,8,8,8,8,8,8,8,8,8,8,8,8,8,8,8,8,8,3,13,13,13,13,13,13,13,13,13,13,13,13,13,13,13,13,13,13,13,4,8
8,8,8,8,8,8,8,8,8,8,8,8,8,8,8,8,8,8,8,8,8,8,8,8,8,8,8,8,8,8,8,8,8,8,8,8,8,8,14,68,68,68,68,68,68,68,68,68,68,68,68,68,68,68,68,242,260,243,5,8
8,8,3,13,13,13,13,13,13,13,13,13,13,13,13,13,13,13,13,13,13,13,13,13,13,13,13,13,13,13,13,13,13,13,13,13,13,13,10,76,76,76,76,76,76,76,76,76,76,76,76,76,76,76,76,266,250,263,5,8
8,8,14,0,0,0,0,0,0,0,0,0,0,84,95,0,0,0,0,0,0,0,0,0,0,0,0,0,0,0,0,0,0,0,0,0,0,0,0,0,0,0,0,0,0,0,0,0,0,0,0,0,0,0,0,0,248,251,5,8
8,8,14,0,0,0,0,0,0,0,0,0,0,84,95,0,0,0,0,0,0,0,0,0,0,0,0,0,0,0,0,0,0,0,0,0,0,0,0,0,0,0,0,0,0,0,0,0,0,0,0,0,0,0,0,0,70,71,5,8
8,8,14,0,0,0,0,0,0,0,0,0,0,84,95,0,0,0,0,0,0,0,0,0,0,0,0,0,0,0,0,0,0,0,0,0,0,0,0,0,0,0,0,0,0,0,0,0,0,0,0,0,0,0,0,0,70,71,5,8
8,8,14,0,0,0,0,0,0,0,0,0,0,84,95,0,0,0,0,0,0,0,0,0,0,0,0,0,0,0,0,0,0,0,0,0,0,0,0,0,0,0,0,0,0,0,0,0,0,0,0,0,0,0,0,0,70,71,5,8
8,8,14,0,0,0,0,0,0,0,0,0,0,84,95,0,0,0,0,0,0,0,0,0,0,0,0,0,0,0,0,0,0,0,0,0,0,0,0,0,0,0,0,0,0,0,0,0,0,0,0,0,0,0,0,0,70,71,5,8
8,8,14,0,0,0,0,0,0,0,0,0,0,84,95,0,0,0,0,0,0,0,0,0,0,0,0,0,0,0,0,0,0,0,0,0,0,0,0,0,0,0,0,0,0,0,0,0,0,0,0,0,0,0,0,0,70,71,5,8
8,8,14,0,0,0,0,0,0,0,0,0,0,84,95,0,0,0,0,0,0,0,0,0,0,0,0,0,0,0,0,0,0,0,0,0,0,0,0,0,0,0,0,0,0,0,0,0,0,0,0,0,0,0,0,0,70,71,5,8
8,8,14,0,0,0,0,0,0,0,0,0,0,84,95,0,0,0,0,0,0,0,0,0,0,0,0,0,0,0,0,0,0,0,0,0,0,0,0,0,0,0,0,0,0,0,0,0,0,0,0,0,0,0,0,0,70,71,5,8
8,8,14,0,0,0,0,0,0,0,0,0,0,84,95,0,0,0,0,0,0,0,0,0,0,0,0,0,0,0,0,0,0,0,0,0,0,0,0,1,6,6,6,2,242,260,243,0,0,0,0,0,0,0,0,0,70,71,5,8
8,8,14,0,0,0,0,0,0,0,0,0,0,84,95,0,0,0,0,0,0,0,0,0,0,0,0,0,0,0,0,0,0,0,0,0,0,0,0,5,8,8,8,14,266,250,263,0,0,0,0,0,0,0,0,0,70,71,5,8
8,8,14,0,0,0,0,0,0,0,0,0,0,84,95,0,0,0,0,0,0,0,0,0,0,0,0,0,0,0,0,0,0,0,0,0,0,0,0,5,8,8,8,14,0,248,251,0,0,0,0,0,0,0,0,0,70,71,5,8
8,8,14,0,0,0,0,0,0,0,0,0,0,84,95,0,0,0,0,0,0,0,0,0,0,0,0,0,0,0,0,0,0,0,0,0,0,0,0,5,8,8,8,14,0,70,71,0,0,0,0,0,0,0,0,0,70,71,5,8
8,8,14,0,0,0,0,0,0,0,0,0,0,84,95,0,0,0,0,0,0,0,0,0,0,0,0,0,0,0,0,0,0,0,0,0,0,0,0,5,3,13,13,10,0,256,259,0,0,0,0,0,0,0,0,0,70,71,5,8
8,8,14,0,0,0,0,0,0,0,0,0,0,84,95,0,0,0,0,0,0,0,0,0,0,0,0,0,0,0,0,0,0,0,0,0,0,0,0,5,14,68,68,68,242,258,263,0,0,0,0,0,0,0,0,0,70,71,5,8
13,13,10,0,0,0,0,0,0,0,0,0,0,84,95,0,0,0,0,0,0,0,0,0,0,0,0,0,0,0,0,0,0,0,0,0,0,0,0,9,10,76,76,76,266,268,267,0,0,0,0,0,0,0,0,0,70,71,5,8
242,260,243,0,0,0,0,0,0,0,0,0,0,84,95,0,0,0,0,0,0,0,0,0,0,0,0,0,0,0,0,0,0,0,0,0,0,0,0,0,0,0,0,0,0,0,0,0,0,0,0,0,0,0,0,0,70,71,5,8
266,250,263,0,0,0,0,0,0,0,0,0,0,84,95,0,0,0,0,0,0,0,0,0,0,0,0,0,0,0,0,0,0,0,0,0,0,0,0,0,0,0,0,0,0,0,0,0,0,0,0,0,0,0,0,0,70,71,5,8
0,248,251,0,0,0,0,0,0,0,0,0,0,84,95,0,0,0,0,0,0,0,0,0,0,0,0,0,0,0,0,0,0,0,0,0,0,0,0,0,0,0,0,0,0,0,0,0,0,0,0,0,0,0,0,0,70,71,5,8
0,70,71,0,0,0,0,0,0,0,0,0,0,84,95,0,0,0,0,0,0,0,0,0,0,0,0,0,0,0,0,0,0,0,0,0,0,0,0,0,0,0,0,0,0,0,0,0,0,0,0,0,0,0,0,0,70,71,5,8
0,70,71,0,0,0,0,0,0,0,0,0,0,84,95,0,0,0,0,0,0,0,0,0,0,0,0,0,0,0,0,0,0,0,0,0,0,0,0,0,0,0,0,0,0,0,0,0,0,0,0,0,0,0,0,0,70,71,5,8
0,256,259,0,0,0,0,0,0,0,0,0,0,84,95,0,0,0,0,0,0,0,0,0,0,0,0,0,0,0,0,0,0,0,0,0,0,0,0,0,0,0,0,0,0,0,0,0,0,0,0,0,0,0,0,0,70,71,5,8
242,258,263,0,0,0,0,0,0,0,0,0,0,84,95,0,0,0,0,0,0,0,0,0,0,0,0,0,0,0,0,0,0,0,0,0,0,0,0,0,0,0,0,0,0,0,0,0,0,0,0,0,0,0,0,0,70,71,5,8
266,268,267,0,0,0,0,0,0,0,0,0,0,84,95,0,0,0,0,0,0,0,0,0,0,0,0,0,0,0,0,0,0,0,0,0,0,0,0,0,0,0,0,0,0,0,0,0,0,0,0,0,0,0,0,0,70,71,5,8
36,36,36,36,36,36,36,36,36,36,210,213,86,91,90,86,212,228,211,0,0,0,0,0,1,6,6,6,2,242,260,243,0,0,0,0,0,0,0,0,0,0,0,0,0,0,0,0,0,0,0,0,0,0,0,0,70,71,5,8
44,44,44,44,44,44,44,44,44,44,234,221,93,93,93,93,220,218,231,0,0,0,0,0,5,8,8,8,14,266,250,263,0,0,0,0,0,0,0,0,0,0,0,0,0,0,0,0,0,0,0,0,0,0,0,0,70,71,5,8
6,6,2,0,0,0,0,0,0,0,0,0,0,0,0,0,0,216,219,0,0,0,0,0,5,8,8,8,14,0,248,251,0,0,0,0,0,0,0,0,0,0,0,0,0,0,0,0,0,0,0,0,0,0,0,0,70,71,5,8
8,8,14,0,0,0,0,0,0,0,0,0,0,0,0,0,0,38,39,0,0,0,0,0,5,8,8,8,14,0,70,71,0,0,0,0,0,0,0,0,0,0,0,0,0,0,0,0,0,0,0,0,0,0,0,0,70,71,5,8
8,8,14,0,0,0,0,0,0,0,0,0,0,0,0,0,0,38,39,0,0,0,0,0,5,3,13,13,10,0,256,259,0,0,0,0,0,0,0,0,0,0,0,0,0,0,0,0,0,0,0,0,0,0,0,0,70,71,5,8
8,8,14,0,0,0,0,0,0,0,0,0,0,0,0,0,0,38,39,0,0,0,0,0,5,14,68,68,68,242,258,263,0,0,0,0,0,0,0,0,0,0,0,0,0,0,0,0,0,0,0,0,0,0,0,0,70,71,5,8
8,8,14,0,0,0,0,0,0,0,0,0,0,0,0,0,0,38,39,0,0,0,0,0,9,10,76,76,76,266,268,267,0,0,0,0,0,0,0,0,0,0,0,0,0,0,0,0,0,0,0,0,0,0,0,0,70,71,5,8
8,8,14,0,0,0,0,0,0,0,0,0,0,0,0,0,0,38,39,0,0,0,0,0,0,0,0,0,0,0,0,0,0,0,0,0,0,0,0,0,0,0,0,0,0,0,0,0,0,0,0,0,0,0,0,0,70,71,5,8
8,8,14,0,0,0,0,0,0,0,0,0,0,0,0,0,0,38,39,0,0,0,0,0,0,0,0,0,0,0,0,0,0,0,0,0,0,0,0,0,0,0,0,0,0,0,0,0,0,0,0,0,0,0,0,0,70,71,5,8
8,8,14,0,0,0,0,0,0,0,0,0,0,0,0,0,0,38,39,0,0,0,0,0,0,0,0,0,0,0,0,0,0,0,0,0,0,0,0,0,0,0,0,0,0,0,0,0,0,0,0,0,0,0,0,0,70,71,5,8
8,8,14,0,0,0,0,0,0,0,0,0,0,0,0,0,0,38,39,0,0,0,0,0,0,0,0,0,0,0,0,0,0,0,0,0,0,0,0,0,0,0,0,0,0,0,0,0,0,0,0,0,0,0,0,0,70,71,5,8
8,8,11,6,6,6,6,6,6,6,6,6,6,6,6,6,2,38,39,0,0,0,0,0,0,0,0,0,0,0,0,0,0,0,0,0,0,0,0,0,0,0,0,0,0,0,0,0,0,0,0,0,0,0,0,0,70,71,5,8
8,8,8,8,8,8,8,8,8,8,8,8,8,8,8,8,14,38,39,0,0,0,0,0,0,0,0,0,0,0,0,0,0,0,0,0,0,0,0,0,0,0,0,0,0,0,0,0,0,0,0,0,0,0,0,0,70,71,5,8
8,8,8,8,8,8,8,8,8,8,8,8,8,8,8,8,14,38,39,0,0,0,0,0,0,0,0,0,0,0,0,0,0,0,0,0,0,0,0,0,0,0,0,0,0,0,0,0,0,0,0,0,0,0,0,0,70,71,5,8
8,8,8,8,8,8,8,8,8,8,8,8,8,8,8,8,14,38,39,0,0,0,0,0,0,0,0,0,0,0,0,0,0,0,0,0,0,0,0,0,0,0,0,0,0,0,0,0,0,0,0,0,0,0,0,0,70,71,5,8
8,8,8,8,8,8,8,8,8,8,8,8,8,8,8,8,14,38,39,0,0,0,0,0,0,0,0,0,0,0,0,0,0,0,0,0,0,0,0,0,0,0,0,0,0,0,0,0,0,0,0,0,0,0,0,0,70,71,5,8
8,8,8,8,8,8,8,8,8,8,8,8,8,8,8,8,14,38,39,0,0,0,0,0,0,0,0,0,0,0,0,0,0,0,0,0,0,0,0,0,0,0,0,0,0,0,0,0,0,0,0,0,0,0,0,0,70,71,5,8
8,8,8,8,8,8,8,8,8,8,8,8,8,8,8,8,14,38,39,0,0,0,0,0,0,0,0,0,0,0,0,0,0,0,0,0,0,0,0,0,0,0,0,0,0,0,0,0,0,0,0,0,0,0,0,0,70,71,5,8
8,8,8,8,8,8,8,8,8,8,8,8,8,8,8,8,14,38,39,0,0,0,0,0,0,0,0,0,0,0,0,0,0,0,0,0,0,0,0,0,0,0,0,0,0,0,0,0,0,0,0,0,0,0,0,0,70,71,5,8
8,8,8,8,8,8,8,8,8,8,8,8,8,8,8,8,14,38,39,0,0,0,0,0,0,0,0,0,0,0,0,0,0,0,0,0,0,0,0,0,0,0,0,0,0,0,0,0,0,0,0,0,0,0,0,0,256,259,5,8
8,8,8,8,8,8,8,8,8,8,8,8,8,8,8,8,14,38,39,240,260,241,68,68,68,68,68,68,68,68,68,68,68,68,68,68,68,68,68,68,68,68,68,68,68,68,68,68,68,68,68,68,68,68,68,242,258,263,5,8
8,8,8,8,8,8,8,8,8,8,8,8,8,8,8,8,14,38,39,262,249,265,76,76,76,76,76,76,76,76,76,76,76,76,76,76,76,76,76,76,76,76,76,76,76,76,76,76,76,76,76,76,76,76,76,266,268,267,5,8
8,8,8,8,8,8,8,8,8,8,8,8,8,8,8,8,14,38,39,248,251,0,0,0,0,0,0,0,0,0,0,0,0,0,0,0,0,0,0,0,0,0,0,0,0,0,0,0,0,0,0,0,0,0,0,0,0,0,5,8
8,8,8,8,8,8,8,8,8,8,8,8,8,8,8,8,14,38,39,70,71,0,0,0,0,0,0,0,0,0,0,0,0,0,0,0,0,0,0,0,0,0,0,0,0,0,0,0,0,0,0,0,0,0,0,0,0,0,5,8
8,8,8,8,8,8,8,8,8,8,8,8,8,8,8,8,14,38,39,70,71,0,0,0,0,0,0,0,0,0,0,0,0,0,0,0,0,0,0,0,0,0,0,0,0,0,0,0,0,0,0,0,0,0,0,0,0,0,5,8
8,8,8,8,8,8,8,8,8,8,8,8,8,8,8,8,14,38,39,70,71,0,0,0,0,0,0,0,0,0,0,0,0,0,0,0,0,0,0,0,0,0,0,0,0,0,0,0,0,0,0,0,0,0,0,0,0,0,5,8
8,8,8,8,8,8,8,8,8,8,8,8,8,8,8,8,14,38,39,70,71,0,0,0,0,0,0,0,0,0,0,0,0,0,0,0,0,0,0,0,0,0,0,0,0,0,0,0,0,0,0,0,0,0,0,0,0,0,5,8
8,8,8,8,8,8,8,8,8,8,8,8,8,8,8,8,14,38,39,70,71,0,0,0,0,0,0,0,0,0,0,0,0,0,0,0,0,0,0,0,0,0,0,0,0,0,0,0,0,0,0,0,0,0,0,0,0,0,5,8
8,8,8,8,8,8,8,8,8,8,8,8,8,8,8,8,14,38,39,70,71,0,0,0,0,0,0,0,0,0,0,0,0,0,0,0,0,0,0,0,0,0,0,0,0,0,0,0,0,0,0,0,0,0,0,0,0,0,5,8
