30,30,23,250,0,191,0,0,0,0,251,16,30,30,30,30,30,30,30,30,30,30,30,30,30,30,30,30,30,30,30,30,30,30,30,30,30,30,30,30,30,30,30,30,30,30,30,30,30,30,30,30,30,30,30,30,30,30,30,30,30,30,30,30,30,30,30,30,30,30,30,30,30,30,30,30,30,30,94,94,94,94,94,94,94,94,94,94,94,94,94,94,94,94,18,30,30,30,30,30,30,30,30,30,30,30,30,30,30,30,30,30,30,30,30,30,30,30,30,30,30,30,30,30
30,30,23,250,0,0,0,0,0,0,251,16,30,30,30,3,28,28,28,28,28,28,28,28,28,28,28,28,28,28,28,28,28,28,28,28,28,28,28,28,28,28,28,4,30,30,30,30,30,30,30,30,30,30,30,30,30,30,30,13,17,3,28,28,28,28,28,28,28,28,28,28,28,28,28,28,28,29,91,92,92,92,92,92,92,92,92,92,92,92,92,92,68,94,18,30,30,30,30,30,30,30,30,30,30,30,30,30,30,30,30,30,30,30,30,30,30,30,30,30,30,30,30,30
30,30,23,244,0,0,0,0,0,0,245,16,30,30,30,23,0,0,0,0,0,0,0,0,0,0,0,0,0,0,0,0,0,0,0,0,0,0,0,0,0,0,182,16,30,30,30,30,30,30,30,30,30,30,30,30,30,30,30,25,94,79,0,0,0,0,0,0,0,0,0,0,0,0,0,0,0,0,0,0,0,0,0,0,0,0,0,0,0,0,0,0,80,94,18,30,30,30,30,30,30,30,30,30,30,30,30,30,30,30,30,30,30,30,30,30,30,30,30,30,30,30,30,30
30,30,23,236,209,149,149,149,149,230,237,16,30,30,30,23,0,0,0,0,0,0,0,0,0,0,0,0,0,0,0,0,0,0,0,0,0,0,0,0,0,0,0,16,30,30,30,30,30,30,30,30,30,30,30,30,30,30,30,25,94,87,0,0,0,0,0,0,0,0,0,0,0,0,0,0,0,0,0,0,0,0,0,0,0,0,0,0,0,0,0,0,80,94,18,30,30,30,30,30,30,30,30,30,30,30,30,30,30,30,30,30,30,30,30,30,30,30,30,30,30,30,30,30
30,30,23,250,170,168,170,170,169,0,251,16,30,30,30,23,0,0,0,0,0,0,0,0,0,0,0,0,0,0,0,0,0,0,0,0,0,0,0,0,0,0,0,16,30,30,30,30,30,30,30,30,30,30,30,30,30,30,30,25,94,87,0,0,0,0,0,0,0,0,0,0,0,0,0,0,0,0,0,0,0,0,0,0,0,0,0,0,0,0,0,0,80,94,18,30,30,30,30,30,30,30,30,30,30,30,30,30,30,30,30,30,30,30,30,30,30,30,30,30,30,30,30,30
30,30,23,250,170,170,168,169,220,228,251,16,30,30,30,23,0,0,0,0,0,0,0,0,0,0,0,0,0,0,0,0,0,0,0,0,0,0,0,0,0,0,0,16,30,30,30,30,30,30,30,30,30,30,30,30,30,30,30,25,94,87,0,0,0,0,0,0,0,0,0,0,0,0,0,0,0,0,0,0,0,0,0,0,0,0,0,0,0,0,0,0,80,94,18,30,30,30,30,30,30,30,30,30,30,30,30,30,30,30,30,30,30,30,30,30,30,30,30,30,30,30,30,30
30,30,23,250,170,170,169,168,170,170,251,16,30,30,30,23,0,0,0,0,0,0,0,0,0,0,0,0,0,0,0,0,0,0,0,0,0,0,0,0,0,0,0,16,30,30,30,30,30,30,30,30,30,30,30,30,30,30,30,25,94,87,0,0,0,0,0,0,0,0,0,0,0,0,0,0,0,0,0,0,0,0,0,0,0,0,0,0,0,0,0,0,80,94,18,30,30,30,30,30,30,30,30,30,30,30,30,30,30,30,30,30,30,30,30,30,30,30,30,30,30,30,30,30
30,30,23,250,170,169,170,170,168,170,251,16,30,30,30,23,0,0,0,0,0,0,0,0,0,0,0,0,0,0,0,0,0,0,0,0,0,0,0,0,0,0,0,16,30,30,30,30,30,30,30,30,30,30,30,30,30,30,30,25,94,87,0,0,0,0,0,0,0,0,0,0,0,0,0,0,0,0,0,0,0,0,0,0,0,0,0,0,0,0,0,0,80,94,18,30,30,30,30,30,30,30,30,30,30,30,30,30,30,30,30,30,30,30,30,30,30,30,30,30,30,30,30,30
30,30,23,244,212,148,148,148,148,208,245,16,30,30,30,23,0,0,0,0,0,0,0,0,0,0,0,0,0,0,0,0,0,0,0,0,0,0,0,0,0,0,0,16,30,30,30,30,30,30,30,30,30,30,30,30,30,30,30,25,94,87,0,0,0,0,0,0,0,0,183,0,0,0,0,0,0,0,0,0,0,0,0,0,0,0,0,0,0,0,0,0,80,94,18,30,30,30,30,30,30,30,30,30,30,30,30,30,30,30,30,30,30,30,30,30,30,30,30,30,30,30,30,30
30,30,23,236,209,149,149,149,149,213,237,16,30,30,30,23,0,0,0,0,0,0,0,0,0,0,0,0,0,0,0,0,0,0,0,0,0,0,0,0,0,0,0,16,30,30,30,30,30,30,30,30,30,30,30,30,30,30,30,25,94,87,0,0,0,0,0,0,0,1,6,6,6,6,2,0,0,0,0,0,0,0,0,0,0,0,0,0,0,0,0,0,80,94,18,30,30,30,30,30,30,30,30,30,30,30,30,30,30,30,30,30,30,30,30,30,30,30,30,30,30,30,30,30
30,30,23,250,170,168,170,170,169,170,251,16,30,30,30,23,0,0,0,0,0,0,0,0,0,0,0,0,0,0,0,0,0,0,0,0,0,0,0,0,0,0,0,16,30,30,30,30,30,30,30,30,30,30,30,30,30,30,30,25,94,87,158,158,158,158,158,158,157,16,30,30,30,30,23,157,158,158,158,158,158,158,158,158,158,158,158,158,158,158,158,157,80,94,18,30,30,30,30,30,30,30,30,30,30,30,30,30,30,30,30,30,30,30,30,30,30,30,30,30,30,30,30,30
30,30,23,250,170,170,168,169,170,170,251,16,30,13,17,31,0,0,0,0,0,0,0,0,0,0,0,0,0,0,0,0,0,0,0,0,0,0,0,0,0,0,0,16,30,30,30,30,30,30,30,30,30,30,30,30,30,30,30,25,94,87,165,165,165,165,165,165,166,16,30,30,30,30,23,166,165,165,165,165,165,165,165,165,165,165,165,165,165,165,165,166,80,94,18,30,30,30,30,30,30,30,30,30,30,30,30,30,30,30,30,30,30,30,30,30,30,30,30,30,30,30,30,30
30,30,23,250,170,170,169,168,170,170,251,16,30,25,94,87,0,0,0,0,0,0,0,0,0,0,0,0,0,0,0,0,0,0,0,0,0,0,0,0,0,0,0,16,30,30,30,30,13,17,17,17,17,17,17,17,17,17,17,81,94,87,0,0,0,0,0,0,0,9,28,28,28,28,10,0,0,0,0,0,0,0,0,0,0,0,0,0,0,0,0,0,80,94,18,30,30,30,30,30,30,30,30,30,30,30,30,30,30,30,30,30,30,30,30,30,30,30,30,30,30,30,30,30
30,30,23,250,170,169,170,170,168,170,251,16,30,25,94,87,0,0,0,0,0,0,0,0,0,0,0,0,0,0,0,0,0,0,0,0,0,0,0,0,0,0,0,16,30,30,30,30,25,94,94,94,94,94,94,94,94,94,94,94,94,87,0,0,0,0,0,0,0,0,0,0,0,0,0,0,0,0,0,0,0,0,0,0,0,0,0,0,0,0,0,0,80,94,18,30,30,30,30,30,30,30,30,30,30,30,30,30,30,30,30,30,30,30,30,30,30,30,30,30,30,30,30,30
30,30,23,244,212,148,148,148,148,208,245,16,30,25,94,87,0,0,0,0,0,0,0,0,0,0,0,0,0,0,0,0,0,0,0,0,0,0,0,0,0,0,0,9,28,28,28,28,29,92,92,92,92,92,92,92,92,92,92,92,92,74,0,0,0,0,0,0,0,0,0,0,0,0,0,0,0,0,0,0,0,0,0,0,0,0,0,0,0,0,0,0,80,94,18,30,30,30,30,30,30,30,30,30,30,30,30,30,30,30,30,30,30,30,30,30,30,30,30,30,30,30,30,30
30,30,23,236,209,149,149,149,149,213,237,16,30,25,94,87,0,0,0,0,0,0,0,0,0,0,0,0,0,0,0,0,0,0,0,0,0,0,0,0,0,0,0,0,0,156,167,0,0,156,167,0,0,0,0,0,0,0,0,0,0,0,0,0,0,0,0,0,0,0,0,0,0,0,0,0,0,0,0,0,0,0,0,0,0,0,0,0,0,0,0,0,80,94,18,30,30,30,30,30,30,30,30,30,30,30,30,30,30,30,30,30,30,30,30,30,30,30,30,30,30,30,30,30
30,30,23,250,170,168,170,170,169,170,251,16,30,25,94,87,0,0,0,0,0,0,0,0,0,0,0,0,0,0,0,0,0,0,0,0,0,0,0,0,0,0,0,0,0,156,167,0,0,156,167,0,0,0,0,0,0,0,0,0,0,0,0,0,0,0,0,0,0,0,0,0,0,0,0,0,0,0,0,0,0,0,0,0,0,0,0,0,0,0,0,0,80,94,18,30,30,30,30,30,30,30,30,30,30,30,30,30,30,30,30,30,30,30,30,30,30,30,30,30,30,30,30,30
30,30,23,250,170,170,168,169,170,170,251,16,30,25,94,87,0,0,0,0,0,0,0,0,0,0,0,0,0,0,0,0,0,0,0,0,0,0,0,0,0,0,0,0,0,156,167,0,0,156,167,0,0,0,0,0,0,0,0,0,0,0,0,0,0,0,0,0,0,0,0,0,0,0,0,0,0,0,0,0,0,0,0,0,0,0,0,0,0,0,0,0,80,94,18,30,30,30,30,30,30,30,30,30,30,30,30,30,30,30,30,30,30,30,30,30,30,30,30,30,30,30,30,30
30,30,23,250,170,170,169,168,170,170,251,16,30,25,94,87,0,0,0,0,0,0,0,0,0,0,0,0,0,0,0,0,0,0,0,0,0,0,0,0,0,0,0,0,0,156,167,0,0,156,167,0,0,0,0,0,0,0,0,0,0,0,0,0,0,0,0,0,0,0,0,0,0,0,0,0,0,0,0,0,0,0,0,0,0,0,0,0,0,0,0,0,80,94,18,30,30,30,30,30,30,30,30,30,30,30,30,30,30,30,30,30,30,30,30,30,30,30,30,30,30,30,30,30
30,30,23,250,170,169,170,170,168,170,251,16,30,25,94,87,0,0,0,0,0,0,0,0,0,0,0,0,0,0,0,0,0,0,0,0,0,0,0,0,0,0,0,0,0,156,167,0,0,156,167,0,0,0,0,0,0,0,0,0,0,0,0,0,0,0,0,0,0,0,0,0,0,0,0,0,0,0,0,0,0,0,0,0,0,0,0,0,0,0,0,0,80,94,18,30,30,30,30,30,30,30,30,30,30,30,30,30,30,30,30,30,30,30,30,30,30,30,30,30,30,30,30,30
30,30,23,244,212,148,148,148,148,208,245,16,30,25,94,87,0,0,0,0,0,0,0,0,0,0,0,0,0,0,0,0,0,0,0,0,0,0,0,0,0,0,0,0,0,164,159,0,0,164,159,0,0,0,0,0,0,0,0,0,0,0,0,0,0,0,0,0,0,0,0,0,0,0,0,0,0,0,0,0,0,0,0,0,0,0,0,0,0,0,0,0,80,94,18,30,30,30,30,30,30,30,30,30,30,30,30,30,30,30,30,30,30,30,30,30,30,30,30,30,30,30,30,30
30,30,23,236,209,149,149,149,149,213,237,16,30,25,94,87,116,98,116,116,116,116,116,116,116,116,116,116,116,98,116,101,157,158,158,158,158,158,158,158,158,158,158,158,157,163,162,157,157,163,162,157,158,158,158,158,158,158,158,158,158,158,158,158,158,158,158,158,158,158,158,158,157,100,116,97,116,116,116,116,116,116,116,116,116,116,116,116,116,116,97,116,80,94,18,30,30,30,30,30,30,30,30,30,30,30,30,30,30,30,30,30,30,30,30,30,30,30,30,30,30,30,30,30
30,30,23,250,170,168,170,170,169,170,251,16,30,25,94,87,124,122,124,124,124,124,124,124,124,124,124,124,124,122,124,109,166,165,165,165,165,165,165,165,165,165,165,165,166,165,165,166,166,165,165,166,165,165,165,165,165,165,165,165,165,165,165,165,165,165,165,165,165,165,165,165,166,108,124,121,124,124,124,124,124,124,124,124,124,124,124,124,124,124,121,124,80,94,18,30,30,30,30,30,30,30,30,30,30,30,30,30,30,30,30,30,30,30,30,30,30,30,30,30,30,30,30,30
30,30,23,250,170,170,168,169,170,170,251,16,30,25,94,87,116,98,116,116,116,116,116,116,116,116,116,116,116,98,116,101,157,158,158,158,158,158,158,158,158,158,158,158,158,158,158,158,158,158,158,158,158,158,158,158,158,158,158,158,158,158,158,157,158,158,157,158,158,158,158,158,157,100,116,97,116,116,116,116,116,116,116,116,116,116,116,116,116,116,97,116,80,94,18,30,30,30,30,30,30,30,30,30,30,30,30,30,30,30,30,30,30,30,30,30,30,30,30,30,30,30,30,30
30,30,23,250,170,170,169,168,170,170,251,16,30,25,94,87,124,122,124,124,124,124,124,124,124,124,124,124,124,122,124,109,166,165,165,165,165,165,165,165,165,165,165,165,165,165,165,165,165,165,165,165,165,165,165,165,165,165,165,165,165,165,165,166,155,154,166,165,165,165,165,165,166,108,124,121,124,124,124,124,124,124,124,124,124,124,124,124,124,124,121,124,80,94,18,30,30,30,30,30,30,30,30,30,30,30,30,30,30,30,30,30,30,30,30,30,30,30,30,30,30,30,30,30
30,30,23,250,170,169,170,170,168,170,251,16,30,25,94,87,0,0,0,0,0,0,0,0,0,0,0,0,0,0,0,0,0,0,0,0,0,0,0,0,0,0,0,0,0,0,0,0,0,0,0,0,0,0,0,0,0,0,0,0,0,0,0,0,164,159,0,0,0,0,0,0,0,0,0,0,0,0,0,0,0,0,0,0,0,0,0,0,0,0,0,0,80,94,18,30,30,30,30,30,30,30,30,30,30,30,30,30,30,30,30,30,30,30,30,30,30,30,30,30,30,30,30,30
30,30,23,244,212,148,148,148,148,208,245,16,30,25,94,87,0,0,0,0,0,0,0,0,0,0,0,0,0,0,0,0,0,0,0,0,0,0,0,0,0,0,0,0,0,0,0,0,0,0,0,0,0,0,0,0,0,0,0,0,0,0,0,0,156,167,0,0,0,0,0,0,0,0,0,0,0,0,0,0,0,0,0,0,0,0,0,0,0,0,0,0,80,94,18,30,30,30,30,30,30,30,30,30,30,30,30,30,30,30,30,30,30,30,30,30,30,30,30,30,30,30,30,30
30,30,23,236,0,0,0,0,0,0,237,16,30,25,94,87,0,0,0,0,0,0,0,0,0,0,0,0,0,0,0,0,0,0,0,0,0,0,0,0,0,0,0,0,0,0,0,0,0,0,0,0,0,0,0,0,0,0,0,0,0,0,0,0,156,167,0,0,0,0,0,0,0,0,0,0,0,0,0,0,0,0,0,0,0,0,0,0,0,0,0,0,80,94,18,30,30,30,30,30,30,30,30,30,30,30,30,30,30,30,30,30,30,30,30,30,30,30,30,30,30,30,30,30
30,30,23,250,0,0,0,0,0,0,251,16,30,25,94,87,0,0,0,0,0,0,0,0,0,0,0,0,0,0,0,0,0,0,0,0,0,0,0,0,0,0,0,0,0,0,0,0,0,0,0,0,0,0,0,0,0,0,0,0,0,0,0,0,156,167,0,0,0,0,0,0,0,0,0,0,0,0,0,0,0,0,0,0,0,0,0,0,0,0,0,0,80,94,18,30,30,30,30,30,30,30,30,30,30,30,30,30,30,30,30,30,30,30,30,30,30,30,30,30,30,30,30,30
30,30,23,250,0,0,0,0,0,0,251,16,30,25,94,87,0,0,0,0,0,0,0,0,0,0,0,0,0,0,0,0,0,0,0,0,0,0,0,0,0,0,0,0,0,0,0,0,0,0,0,0,0,0,0,0,0,0,0,0,0,0,0,0,156,167,0,0,0,0,0,0,0,0,0,0,0,0,0,0,0,0,0,0,0,0,0,0,0,0,0,0,80,94,18,30,30,30,30,30,30,30,30,30,30,30,30,30,30,30,30,30,30,30,30,30,30,30,30,30,30,30,30,30
30,30,23,250,0,0,0,0,0,0,251,16,30,25,94,87,0,0,0,0,0,0,0,0,0,0,0,0,0,0,0,0,0,0,0,0,0,0,0,0,0,0,0,0,0,0,0,0,0,0,0,0,0,0,0,0,0,0,0,0,0,0,0,0,156,167,0,0,0,0,0,0,0,0,0,0,0,0,0,0,0,0,0,0,0,0,0,0,0,0,0,0,80,94,18,30,30,30,30,30,30,30,30,30,30,30,30,30,30,30,30,30,30,30,30,30,30,30,30,30,30,30,30,30
30,30,23,250,0,0,0,0,0,0,251,16,30,25,94,87,0,0,0,0,0,0,0,0,0,0,0,0,0,0,0,0,0,0,0,0,0,0,0,0,0,0,0,0,0,0,0,0,0,0,0,0,0,0,0,0,0,0,0,0,0,0,0,0,156,167,0,0,0,0,0,0,0,0,0,0,0,0,0,0,0,0,0,0,0,0,0,0,0,0,0,0,80,94,18,30,30,30,30,30,30,30,30,30,30,30,30,30,30,30,30,30,30,30,30,30,30,30,30,30,30,30,30,30
30,30,23,244,0,0,0,0,0,0,245,16,30,25,94,87,0,0,0,0,0,0,0,0,0,0,0,0,0,0,0,0,0,0,0,0,0,0,0,0,0,0,0,0,0,0,0,0,0,0,0,0,0,0,0,0,0,0,0,0,0,0,0,0,164,159,0,0,0,0,0,0,0,0,0,0,0,0,0,0,0,0,0,0,0,0,0,0,0,0,0,0,80,94,18,30,30,30,30,30,30,30,30,30,30,30,30,30,30,30,30,30,30,30,30,30,30,30,30,30,30,30,30,30
30,30,23,236,231,149,149,149,149,213,237,16,30,25,83,87,0,0,0,0,0,0,0,0,0,0,0,0,0,0,0,0,0,0,0,0,0,0,0,0,0,0,0,0,0,0,0,0,0,0,0,0,0,0,65,70,70,70,70,70,70,70,70,70,70,70,70,70,70,70,70,70,70,70,70,70,66,0,0,0,0,0,0,0,0,0,0,0,0,0,0,0,80,94,18,30,30,30,30,30,30,30,30,30,30,30,30,30,30,30,30,30,30,30,30,30,30,30,30,30,30,30,30,30
30,30,23,250,227,168,170,170,169,170,251,16,30,25,85,87,0,0,0,0,0,0,0,0,0,0,0,0,0,0,0,0,0,0,0,0,0,0,0,0,0,0,0,0,0,0,0,0,0,0,0,0,0,0,80,94,94,94,94,94,94,94,94,94,94,94,94,94,94,94,94,83,84,85,94,94,87,157,158,158,158,158,158,158,158,158,158,158,158,158,158,157,80,94,18,30,30,30,30,30,30,30,30,30,30,30,30,30,30,30,30,30,30,30,30,30,30,30,30,30,30,30,30,30
30,30,23,250,0,223,168,169,170,170,251,16,30,25,94,87,0,0,0,0,0,0,0,0,0,0,0,0,0,0,0,0,0,0,0,0,0,0,0,0,0,0,0,0,0,0,0,0,0,0,0,0,0,0,80,94,90,26,26,26,26,26,26,26,26,26,26,26,89,94,83,84,85,94,94,94,87,166,165,165,165,165,165,165,165,165,165,165,165,165,165,166,80,94,18,30,30,30,30,30,30,30,30,30,30,30,30,30,30,30,30,30,30,30,30,30,30,30,30,30,30,30,30,30
30,30,23,250,0,231,169,168,170,170,251,16,30,25,94,87,0,0,0,0,0,0,0,0,0,0,0,0,0,0,0,0,0,0,0,0,0,0,0,0,0,0,0,0,0,0,0,0,0,0,0,0,0,0,80,94,18,3,28,28,28,28,28,28,28,28,28,28,29,92,92,92,92,92,92,92,74,0,0,0,0,0,0,0,0,0,0,0,0,0,0,0,80,94,18,30,30,30,30,30,30,30,30,30,30,30,30,30,30,30,30,30,30,30,30,30,30,30,30,30,30,30,30,30
30,30,23,250,221,169,170,170,168,170,251,16,30,25,94,87,0,0,0,0,0,0,0,0,0,0,0,0,0,0,0,0,0,0,0,0,0,0,0,0,0,0,0,0,0,0,0,0,0,0,0,0,0,0,80,94,18,23,0,0,0,0,0,0,0,0,0,0,0,0,0,0,0,0,0,0,0,0,0,0,0,0,0,0,0,0,0,0,0,0,0,0,80,94,18,30,3,28,28,28,28,28,28,28,28,28,28,28,28,28,28,28,28,28,28,28,28,28,28,28,28,28,28,28
30,30,23,244,212,148,148,148,148,208,245,16,30,25,94,87,0,0,0,0,0,0,0,0,0,0,0,0,0,0,0,0,0,0,0,0,0,0,0,0,0,0,0,0,0,0,0,0,0,0,0,0,0,0,80,94,18,23,0,0,0,0,0,0,0,0,0,0,0,0,0,0,0,0,0,0,0,0,0,0,0,0,0,0,0,0,0,0,0,0,0,0,80,94,18,30,23,0,0,0,0,0,0,0,0,0,0,0,0,0,0,0,0,0,0,0,0,0,0,54,55,0,0,0
30,30,23,236,209,149,149,149,149,213,237,16,30,25,94,87,0,0,0,0,0,0,0,0,0,0,0,0,0,0,0,0,0,0,0,0,0,0,0,0,0,0,0,0,0,0,0,0,0,0,0,0,0,0,80,94,18,23,0,0,0,0,0,0,0,0,0,0,0,0,0,0,0,0,0,0,0,0,0,0,0,0,0,0,0,0,0,0,0,0,0,0,80,94,18,30,23,0,0,0,0,0,0,0,0,0,0,0,0,0,0,0,0,0,0,0,0,0,0,54,55,0,0,0
30,30,23,250,170,168,170,170,169,170,251,16,30,25,94,87,0,0,0,0,0,0,0,0,0,0,0,0,0,0,0,0,0,0,0,0,0,0,0,0,0,0,0,0,0,0,0,0,0,0,0,0,0,0,80,94,18,23,0,0,0,0,0,0,0,0,0,0,0,0,0,0,0,0,0,0,0,0,0,0,0,0,0,0,0,0,0,0,0,0,0,0,80,94,18,30,23,0,0,0,0,0,0,0,0,0,0,0,0,0,0,0,0,0,0,0,0,0,0,54,55,0,0,0
30,30,23,250,170,170,168,169,170,170,251,16,30,25,94,87,0,0,0,0,0,0,0,0,0,0,0,0,0,0,0,0,0,0,0,0,0,0,0,0,0,0,0,0,0,0,0,0,0,0,0,0,0,0,80,94,18,23,0,0,0,0,0,0,0,0,0,0,0,0,0,0,0,0,0,0,0,0,0,0,0,0,0,0,0,0,0,0,0,0,0,0,80,94,18,30,23,0,0,0,0,0,0,0,0,0,0,0,0,0,0,0,0,0,0,0,0,0,0,54,55,0,0,0
30,30,23,250,170,170,169,168,170,170,251,16,30,25,94,87,0,0,0,0,0,0,0,190,0,0,0,0,0,0,0,0,0,0,0,0,0,0,0,0,0,0,0,0,0,0,0,0,0,0,0,0,0,0,80,94,18,23,0,0,0,0,0,0,0,0,0,0,0,0,0,0,0,0,0,0,0,0,0,0,0,0,0,0,0,0,0,0,0,0,0,0,80,94,18,30,23,0,0,0,0,0,0,0,0,0,0,0,0,0,0,0,0,0,0,0,0,0,0,54,55,0,0,0
30,30,23,250,170,169,170,170,168,170,251,16,30,25,94,87,0,0,0,0,0,0,0,0,0,0,0,0,0,0,0,0,0,0,0,0,0,0,0,0,0,0,0,0,0,0,0,0,0,0,0,0,0,0,8,26,22,23,0,0,0,0,0,0,0,0,0,0,0,0,0,0,0,0,0,0,0,0,0,0,0,0,0,0,0,0,0,0,0,0,0,0,80,94,18,30,23,0,0,0,0,0,0,0,0,0,0,0,0,0,0,0,0,0,0,0,0,0,0,54,55,0,0,0
30,30,23,244,212,148,148,148,148,208,245,16,30,25,94,87,0,0,0,0,0,0,0,0,0,0,0,0,0,0,0,0,0,0,0,0,0,0,0,0,0,0,0,0,0,0,0,0,0,0,0,0,0,0,16,30,30,23,0,0,0,0,0,0,0,0,0,0,0,0,0,0,0,0,0,0,0,0,0,0,0,0,0,0,0,0,0,0,0,0,0,0,80,94,18,30,23,0,0,0,0,0,0,0,0,0,0,0,0,0,0,0,0,0,0,0,0,0,0,54,55,0,0,0
30,30,23,236,209,149,149,149,149,213,237,16,30,25,94,95,0,0,0,0,0,0,0,0,0,0,0,0,0,0,0,0,0,0,0,0,0,0,0,0,0,0,0,0,0,0,0,0,0,0,0,0,0,0,16,30,30,23,0,0,183,0,0,0,0,0,0,0,0,0,0,0,0,0,0,0,0,0,0,0,0,0,0,0,0,0,0,0,0,0,0,0,80,94,18,30,11,6,6,6,6,6,6,6,6,6,6,6,6,6,6,6,6,6,6,6,6,6,6,6,6,6,6,6
30,30,23,250,227,168,170,170,169,170,251,16,30,21,94,75,70,70,70,70,70,70,70,70,70,70,70,5,6,6,6,6,2,0,0,0,0,0,0,0,0,0,0,0,0,0,0,0,0,0,0,0,0,0,16,30,30,11,6,6,6,6,6,6,6,6,6,6,6,6,6,6,6,6,6,6,2,0,0,0,0,0,0,0,0,0,0,0,0,0,0,0,80,94,18,30,30,30,30,30,30,30,30,30,30,30,30,30,30,30,30,30,30,30,30,30,30,30,30,30,30,30,30,30
30,30,23,250,0,221,168,169,170,170,251,16,30,25,94,94,94,94,94,94,94,94,94,94,94,94,94,18,30,30,30,30,23,52,52,52,52,52,34,52,37,198,198,198,197,198,198,197,198,198,198,198,198,197,16,30,30,30,30,30,30,30,30,30,30,30,30,30,30,30,30,30,30,30,30,30,23,197,198,198,198,198,198,198,198,198,198,198,198,198,198,197,80,94,82,17,17,17,17,17,17,17,17,17,17,17,17,17,14,30,30,30,30,30,30,30,30,30,30,30,30,30,30,30
30,30,23,250,0,231,169,168,170,170,251,16,30,21,26,26,26,26,26,26,26,26,26,26,26,26,26,22,30,30,30,30,23,60,60,60,60,60,58,60,45,205,205,205,206,195,194,206,205,205,205,205,205,206,16,30,30,30,30,30,30,30,30,30,30,30,30,30,30,30,30,30,30,30,30,30,23,206,205,205,205,205,205,205,205,205,205,205,205,205,205,206,80,94,94,94,94,94,94,94,94,94,94,94,94,94,94,94,18,30,30,30,30,30,30,30,30,30,30,30,30,30,30,30
30,30,23,250,224,169,170,170,168,170,251,9,28,28,28,28,28,28,28,28,28,28,28,28,28,28,28,28,28,28,28,28,10,0,0,0,0,0,0,0,0,0,0,0,0,204,199,0,0,0,0,0,0,0,9,28,28,28,28,28,28,28,28,28,28,28,28,28,28,28,28,28,28,28,28,28,10,0,0,0,0,0,0,0,0,0,0,0,0,0,0,0,73,92,92,92,92,92,92,92,92,92,92,92,92,92,92,92,27,28,28,28,28,28,28,28,28,28,28,28,28,28,28,28
30,30,23,244,212,148,148,148,148,208,240,248,248,248,248,235,234,248,248,248,248,235,234,248,248,248,248,235,234,248,248,248,248,235,234,248,248,248,248,235,234,248,248,248,239,196,207,0,0,0,0,0,234,248,248,248,248,235,234,248,248,248,248,235,234,248,248,248,248,235,234,248,248,248,248,235,234,248,248,248,248,235,0,0,0,0,0,0,0,0,0,0,0,0,0,0,0,0,0,0,0,0,0,0,0,0,184,0,0,0,0,0,0,0,0,0,0,0,0,54,55,0,0,0
30,30,23,236,210,149,149,149,149,219,210,170,170,170,170,215,210,170,170,170,170,215,210,170,170,170,170,215,210,170,170,170,170,215,210,170,170,170,170,215,210,226,0,0,0,196,207,221,0,0,0,0,210,170,170,170,170,215,210,170,222,229,170,215,210,170,170,170,170,215,210,170,170,225,196,207,210,220,0,0,228,0,0,231,226,0,228,0,224,0,0,0,0,0,228,0,0,0,228,0,0,0,0,0,0,0,0,0,0,0,0,0,0,0,0,0,0,0,0,40,43,0,0,0
30,30,23,250,170,168,170,170,169,151,150,168,170,170,169,151,150,168,170,170,169,151,150,168,170,170,169,151,150,168,170,170,169,151,150,168,170,170,169,151,150,168,0,0,0,196,150,168,220,224,169,226,150,168,170,170,169,151,150,168,170,228,169,151,150,168,170,170,169,151,150,168,170,220,196,207,223,168,228,231,169,151,150,168,220,221,169,220,150,168,226,224,228,0,150,168,220,231,169,151,0,0,0,0,0,0,0,0,0,0,0,0,0,0,0,0,0,0,0,54,55,0,0,0
30,30,23,250,170,170,168,169,170,151,150,170,168,169,170,151,150,170,168,169,170,151,150,170,168,169,170,151,150,170,168,169,170,151,150,170,168,169,170,151,150,222,0,0,0,196,150,170,168,169,170,230,150,170,168,169,170,151,150,170,168,169,170,151,150,170,168,169,170,151,150,170,168,169,196,207,231,170,168,169,170,151,150,170,168,169,170,151,150,170,168,169,220,228,150,170,168,169,170,151,0,0,0,0,0,0,0,0,0,0,0,0,0,0,0,0,0,0,0,54,55,32,52,52
30,30,23,250,170,170,169,168,170,151,150,170,169,168,170,151,150,170,169,168,170,151,150,170,169,168,170,151,150,170,169,168,170,151,150,170,169,168,170,151,150,224,169,168,226,196,150,170,169,168,170,226,150,170,169,168,170,151,150,170,169,168,170,151,150,170,169,168,170,151,150,170,169,230,196,207,150,170,169,168,170,151,150,170,169,168,170,151,150,170,169,168,170,151,150,170,169,168,170,151,0,0,0,0,0,0,0,0,0,0,0,0,0,0,0,0,0,0,0,54,55,54,41,60
30,30,23,250,170,169,170,170,168,151,150,169,222,223,168,151,150,169,170,170,168,151,150,169,170,170,168,151,150,169,170,170,168,151,150,169,170,170,168,151,150,169,170,170,168,196,150,169,170,170,168,230,150,169,170,170,168,151,150,169,170,170,168,151,150,169,170,170,168,151,150,169,230,0,196,207,150,169,170,170,168,151,150,169,222,223,168,151,150,169,170,170,168,151,150,169,170,170,168,230,0,0,0,0,0,0,0,0,0,0,0,0,0,0,0,0,0,0,0,54,55,54,55,0
30,30,23,250,169,170,170,170,170,211,214,170,230,229,170,211,214,170,170,170,170,211,214,170,170,170,170,211,214,170,170,170,170,211,214,170,170,170,170,211,214,170,170,170,170,211,214,170,170,170,170,230,214,222,223,170,170,211,214,170,170,170,170,211,214,170,170,170,170,211,214,226,0,0,196,207,214,170,170,170,170,211,214,170,230,231,170,211,214,170,170,170,170,211,214,170,170,170,230,0,0,0,0,0,0,0,0,0,0,0,0,0,0,0,0,0,0,0,0,54,55,48,51,0
30,30,23,246,249,249,249,249,249,243,242,249,249,249,249,243,242,249,249,249,249,243,242,249,249,249,249,243,242,249,249,249,249,243,242,249,249,249,249,243,242,249,249,249,249,243,242,249,249,249,249,243,242,249,249,249,249,243,242,249,249,249,249,243,242,249,249,249,249,243,242,249,249,249,249,243,242,249,249,249,249,243,242,249,249,249,249,243,242,249,249,249,249,243,242,249,249,249,249,249,243,0,0,0,0,0,0,0,0,0,0,0,0,0,0,0,0,0,0,54,55,54,55,0
30,30,11,6,6,6,6,6,6,6,6,6,6,6,6,6,6,6,6,6,6,6,6,6,6,6,6,6,6,6,6,6,6,6,6,6,6,6,6,6,6,6,6,6,6,6,6,6,6,6,6,6,6,6,6,6,6,6,6,6,6,6,6,6,6,6,6,6,6,6,6,6,6,6,6,6,6,6,6,6,6,6,6,6,6,6,6,6,6,6,6,6,6,6,6,6,6,6,6,6,6,6,6,6,6,6,6,6,6,2,236,0,0,0,0,0,0,237,1,6,6,6,6,6
30,30,30,30,30,30,30,30,30,30,30,30,30,30,30,30,30,30,30,30,30,30,30,30,30,30,30,30,30,30,30,30,30,30,30,30,30,30,30,30,30,30,30,30,30,30,30,30,30,30,30,30,30,30,30,30,30,30,30,30,30,30,30,30,30,30,30,30,30,30,30,30,30,30,30,30,30,30,30,30,30,30,30,30,30,30,30,30,30,30,30,30,30,30,30,30,30,30,30,30,30,30,30,30,30,30,30,30,30,23,250,0,0,171,228,221,213,251,16,30,30,30,30,30
